11111111111111111111111111111111111111111111111
101001010010000010100100000011000010100100C0011
1010010010101010001001000C0011000010100100C0011
1P0000000C00C000000C0000CEC011C0000000C00100C01
110000000000000C00000C000C000C0000000C00100C001
11111111111111111111111111111111111111111111111