1111111111111111111111111111111111111111111111111
1E0000000000000C00000C00000000000C000000000000001
1000000000000000000000000000000000000000000000001
1010010010101010001001000000010100001001000101001
1P0000000C00C0000000000000000000C0000000000000C11
1000000000000000000000000000000000000000000000001
1010010010101010001001000000010101001000000010001
100000000C00C0000000000000000000C0000000000000C01
1010010100100000101001000000010101001000000010001
1010010010101010001001000000010101001000000010101
100000000C00C0000000000000000000C1001000000010101
1010010100100000101001000000010101001000000010101
1000000000000000000000000000000000000000000000001
100000000C00C0000000000000000000C0001000000010101
1010010100100000101001000000010101001000000010101
1010010010101010001001000000010101001000000010101
100000000C00C0000000000000000000C1001000000010101
1010010100100000101001000000010101001000000010101
1010010010101010001001000000010101001000000010101
100000000C00C0000000000000000000C0001000000010101
1010010100100000101001000000010101001000000010101
1010010010101010001001000000010101001000000010101
100000000C00C0000000000000000000C1001000000010101
1010010010101010001001000000010101001000000010101
100000000C00C0000000000000000000C1001000000010101
1111111111111111111111111111111111111111111111111