111111111111111111111111111111111111111
1E0000000000000C00000C0C000000000000001
100000000000000000000000000000000000001
111111111111111111111100001001000101111
1P0000000C10C000000001C0000000000000C01
100000000010000000000100000000000011001
101001001010101000100101001000000011001
100000000C10C000000001C0000000000000C01
101001010010000010100101001000000011111
101001001010101000100101001000000010101
100000000C10C000000001C1001000000010101
101001010010000010100101001000000010101
100000000010000000000100000000000000001
100000000C10C000000001C0001000000010101
101001010010000010100101001000000010101
101001001010101000100101001000000010101
100000000C10C000000001C1001000000010101
101001010010000010100101001000000010101
101001001010101000100101001000000010101
100000000C10C000000001C0001000000010101
101001010010000010100101001000000010101
101001001010101000100101001000000010101
100000000C10C000000001C1001000000010101
101001001010101000100101001000000010101
100000000C00C000000000C1001000000010101
111111111111111111111111111111111111111

