11111111111111
10100101001001
1P0000001C0001
100E000E000001
10100100101011
11111111111111